+---+---+---+---+---+---+
|                       |
+                       +
|                       |
+       +---+---+       +
|       |               |
+       +               +
|       |               |
+       +---+---+       +
|                       |
+                       +
|                       |
+---+---+       +---+---+
|                       |
+                       +
|                       |
+       +---+---+       +
|               |       |
+               +       +
|               |       |
+---+---+       +       +
|                       |
+                       +
|                       |
+       +---+---+       +
|                       |
+                       +
|                       |
+---+---+---+---+---+---+